1 22 -1 -320 394 3488 32 0
2 35 -1 55 338 0 0 0
3 35 -1 180 273 0 0 0
4 35 -1 310 338 0 0 0
5 35 -1 440 273 0 0 0
6 35 -1 565 338 0 0 0
7 35 -1 700 273 0 0 0
8 35 -1 820 338 0 0 0
9 35 -1 950 273 0 0 0
10 35 -1 1080 338 0 0 0
11 35 -1 1205 273 0 0 0
12 35 -1 1335 148 0 0 0
13 35 -1 1715 148 0 0 0
14 35 -1 1850 338 0 0 0
15 35 -1 1975 148 0 0 0
16 35 -1 2100 338 0 0 0
17 35 -1 2230 338 0 0 0
18 35 -1 2355 338 0 0 0
19 35 -1 2480 338 0 0 0
20 35 -1 2605 338 0 0 0
21 35 -1 2735 268 0 0 0
22 35 -1 2870 148 0 0 0
28 22 -1 1376 265 96 32 0
29 22 -1 1505 200 320 32 0
30 22 -1 1855 265 160 32 0
31 22 -1 2785 200 544 32 0
32 22 -1 3200 390 384 32 0
33 22 -1 3330 265 96 32 0
34 22 -1 3057 230 32 160 0
35 22 -1 3057 76 32 32 0
36 22 -1 3585 233 32 96 0
37 22 -1 3618 233 96 160 0
38 22 -1 3585 394 132 32 0
39 22 -1 3585 332 32 32 0
40 22 -1 3585 364 32 32 0
41 42 -1 3190 431 40 10 0
42 22 -1 2912 654 590 32 0
35 22 -1 3265 590 64 32 0
44 34 -1 3240 560 0 0 0
46 22 -1 3584 654 64 32 0
47 22 -1 3713 654 288 32 0
48 22 -1 4079 460 16 224 0
49 22 -1 4032 720 64 32 0
50 22 -1 3967 780 64 32 0
51 22 -1 4001 654 32 32 0
52 22 -1 3713 233 64 32 0
53 22 -1 3713 394 96 32 0
54 34 1 1236 377 0 0 0
55 33 -1 1385 195 0 0 0
56 34 1 2580 370 0 0 0
57 33 -1 2790 130 0 0 0
58 34 -1 3520 365 0 0 0
59 33 1 3373 195 0 0 0
60 34 1 1425 240 0 0 0
61 33 -1 1525 130 0 0 0
62 34 -1 1860 240 0 0 0
63 33 1 1770 130 0 0 0
64 20 -1 3054 105 0 0 0
65 42 -1 3985 717 40 40 0
66 42 -1 3460 778 504 30 0
67 42 -1 3180 108 100 100 0
69 33 1 3115 325 0 0 0
71 35 -1 1595 99 0 0 0
72 22 -1 2015 269 32 32 0
81 42 -1 3807 468 30 20 0
82 34 -1 3940 610 0 0 0
83 33 1 3717 320 0 0 0
85 22 -1 3840 394 1792 32 0
86 22 -1 3776 267 96 32 0
88 34 -1 3970 370 0 0 0
89 33 1 3805 216 0 0 0
90 22 -1 3903 202 416 32 0
91 22 -1 4030 76 64 32 0
92 22 -1 4078 235 16 160 0
93 20 -1 4067 105 0 0 0
94 42 -1 4195 110 100 100 0
95 141 -1 1000 200 0 0 0
96 141 -1 1200 200 0 0 0
97 141 -1 2000 200 0 0 0
98 142 -1 1393 230 0 0 0
99 142 -1 1761 160 0 0 0
100 142 -1 1954 230 0 0 0
101 143 -1 3474 100 0 0 0
102 143 -1 3513 200 0 0 0
103 144 -1 3300 780 0 0 0
104 144 -1 3940 780 0 0 0
105 150 -1 5276 95 0 0 0
106 22 -1 4350 265 352 32 2
107 22 -1 5537 265 96 32 2
108 23 -1 5616 80 16 96 3
109 23 -1 5616 303 16 96 3
110 22 -1 5440 325 64 32 2



// id 124 - kích ho?t boss
 
c?u thang 34  bottom, 33 top
id 45: object ?n -> tr? lên tru?c khi xu?ng h? nu?c -> t? sinh ra
id 71: Holy Water

id 72: brick -> a bonus

id 39: brick 4 ô -> ch? effect
id 40: brick 3 ô ->Pot Roast
id 41: object ?n -> xu?ng h? nu?c
 
id 51: brick 2 -> effect
id 65: object ?n -> bonus
id 66: object ?n -> ch?m nu?c -> ch?t
id 67: object ?n -> box xác nh?n simon dã qua c?a

id 23, 98: cross

// id 81: object ?n -> ra kh?i h? nu?c phía ph?i
id 86: object ?n -> vào h? nu?c phía ph?i


// id 64, type 26 Object ?n dùng d? m? c?a 

