1 31 -1 167 300 32 64 3
2 31 -1 431 300 32 64 1
3 31 -1 685 300 32 64 1
4 31 -1 930 300 32 64 2
5 31 -1 1197 300 32 64 3
6 21 -1 0 360 1536 32 0
7 32 -1 1364 300 50 10 0