1 22 -1 -320 394 3488 32 0
2 35 -1 55 338 0 0 0
3 35 -1 180 273 0 0 0
4 35 -1 310 338 0 0 0
5 35 -1 440 273 0 0 0
6 35 -1 565 338 0 0 0
7 35 -1 700 273 0 0 0
8 35 -1 820 338 0 0 0
9 35 -1 950 273 0 0 0
10 35 -1 1080 338 0 0 0
11 35 -1 1205 273 0 0 0
12 35 -1 1335 148 0 0 0
13 35 -1 1715 148 0 0 0
14 35 -1 1850 338 0 0 0
15 35 -1 1975 148 0 0 0
16 35 -1 2100 338 0 0 0
17 35 -1 2230 338 0 0 0
18 35 -1 2355 338 0 0 0
19 35 -1 2480 338 0 0 0
20 35 -1 2605 338 0 0 0
21 35 -1 2735 268 0 0 0
22 35 -1 2870 148 0 0 0
28 22 -1 1376 265 96 32 0
29 22 -1 1505 200 320 32 0
30 22 -1 1855 265 160 32 0
31 22 -1 2785 200 544 32 0
32 22 -1 3200 390 384 32 0
33 22 -1 3330 265 96 32 0
34 22 -1 3057 230 32 160 0
35 22 -1 3057 76 32 32 0
36 22 -1 3585 233 32 96 0
37 22 -1 3618 233 96 160 0
38 22 -1 3585 394 132 32 0
39 22 -1 3585 332 32 32 0
40 22 -1 3585 364 32 32 0
41 42 -1 3190 431 40 10 0
42 22 -1 2912 654 590 32 0
35 22 -1 3265 590 64 32 0
44 34 -1 3240 560 0 0 0
46 22 -1 3584 654 64 32 0
47 22 -1 3713 654 288 32 0
48 22 -1 4079 460 16 224 0
49 22 -1 4032 720 64 32 0
50 22 -1 3967 780 64 32 0
51 22 -1 4001 654 32 32 0
52 22 -1 3713 233 64 32 0
53 22 -1 3713 394 96 32 0
54 34 1 1236 377 0 0 0
55 33 -1 1385 195 0 0 0
56 34 1 2580 370 0 0 0
57 33 -1 2790 130 0 0 0
58 34 -1 3520 365 0 0 0
59 33 1 3373 195 0 0 0
60 34 1 1425 240 0 0 0
61 33 -1 1525 130 0 0 0
62 34 -1 1860 240 0 0 0
63 33 1 1770 130 0 0 0
64 20 -1 3054 105 0 0 0
65 42 -1 3985 717 40 40 0
66 42 -1 3460 778 504 30 0
67 42 -1 3180 108 100 100 0
69 33 1 3115 325 0 0 0
71 35 -1 1595 99 0 0 0
72 22 -1 2015 269 32 32 0
81 42 -1 3807 468 30 20 0
82 34 -1 3940 610 0 0 0
83 33 1 3717 320 0 0 0
85 22 -1 3840 394 1792 32 0
86 22 -1 3776 267 96 32 0
88 34 -1 3970 370 0 0 0
89 33 1 3805 216 0 0 0
90 22 -1 3903 202 416 32 0
91 22 -1 4030 76 64 32 0
92 22 -1 4078 235 16 160 0
93 20 -1 4067 105 0 0 0
94 42 -1 4195 110 100 100 0
95 141 -1 1500 200 0 0 0
96 142 -1 1393 230 0 0 0
97 142 -1 1761 160 0 0 0
98 142 -1 1954 230 0 0 0
99 143 -1 3513 100 0 0 0
100 144 -1 3300 780 0 0 0
101 150 -1 5276 95 0 0 0

99 22 -1 4350 268 352 32 0
100 22 -1 5537 268 96 32 0
101 22 -1 5616 76 16 96 0
102 22 -1 5616 299 16 96 0

103 22 -1 5440 333 32 32 0
104 22 -1 5472 333 32 32 0
105 26 -1 5613 174 0 0 0

106 35 -1 4274 150 0 0 0
107 35 -1 4404 208 0 0 0
108 35 -1 4141 277 0 0 0
109 35 -1 4530 150 0 0 0

110 35 -1 4668 338 0 0 0
111 35 -1 4796 273 0 0 0
112 35 -1 4920 338 0 0 0
 
113 35 -1 5045 338 0 0 0
114 35 -1 5169 273 0 0 0
115 35 -1 5296 338 0 0 0

116 35 -1 5424 273 0 0 0
117 35 -1 5557 273 0 0 0
 
118 34 -1 4355 230 0 0 0
119 33 1 4260 140 0 0 0

120 34 -1 4802 370 0 0 0
121 33 1 4643 210 0 0 0

122 34 1 5456 316 0 0 0
123 33 -1 5555 215 0 0 0
 
 
124 42 -1 5404 318 100 100 0

// id 124 - kích ho?t boss
 
c?u thang 34  bottom, 33 top
id 45: object ?n -> tr? lên tru?c khi xu?ng h? nu?c -> t? sinh ra
id 71: Holy Water

id 72: brick -> a bonus

id 39: brick 4 ô -> ch? effect
id 40: brick 3 ô ->Pot Roast
id 41: object ?n -> xu?ng h? nu?c
 
id 51: brick 2 -> effect
id 65: object ?n -> bonus
id 66: object ?n -> ch?m nu?c -> ch?t
id 67: object ?n -> box xác nh?n simon dã qua c?a

id 23, 98: cross

// id 81: object ?n -> ra kh?i h? nu?c phía ph?i
id 86: object ?n -> vào h? nu?c phía ph?i


// id 64, type 26 Object ?n dùng d? m? c?a 

